NO ./texture/Wall.xpm
WE ./texture/Marble.xpm


EA ./texture/Grass.xpm
SO ./texture/Stone.xpm




C 128,128,128
F 176,48,48


11111111111111111111111111111
1000000000110000000000001
1011000001110000000000001
1001000000000000000000001
1111111110110000011100001
1000000000110000011110111111111
111101110011000011100000010001
111101110000000111010000010001
110000001100000111000000010001
1000000000000N0000000000000001
100000000000000000000000000001
110000011101010111111111000011
11110111 1110101 111111000001 
11111111 1111111 111111111111